age,amount,balance,customer_id,date,movement,bin_age,year,month,day,dow,annual_salary
26,16.25,35.39,CUS-2487424745,8/1/2018,debit,20-30,2018,8,1,Wednesday,52855.65
26,14.19,21.2,CUS-2487424745,8/1/2018,debit,20-30,2018,8,1,Wednesday,52855.65
26,3.25,17.95,CUS-2487424745,8/1/2018,debit,20-30,2018,8,1,Wednesday,52855.65
26,14.1,3.85,CUS-2487424745,8/1/2018,debit,20-30,2018,8,1,Wednesday,52855.65
26,10.67,1006.85,CUS-2487424745,8/1/2018,debit,20-30,2018,8,1,Wednesday,52855.65
26,11.28,995.57,CUS-2487424745,8/1/2018,debit,20-30,2018,8,1,Wednesday,52855.65
26,8.99,986.58,CUS-2487424745,8/1/2018,debit,20-30,2018,8,1,Wednesday,52855.65
26,10.32,976.26,CUS-2487424745,8/1/2018,debit,20-30,2018,8,1,Wednesday,52855.65
26,8.11,968.15,CUS-2487424745,8/2/2018,debit,20-30,2018,8,2,Thursday,52855.65
26,11.23,956.92,CUS-2487424745,8/2/2018,debit,20-30,2018,8,2,Thursday,52855.65
26,7.7,949.22,CUS-2487424745,8/2/2018,debit,20-30,2018,8,2,Thursday,52855.65
26,7.99,941.23,CUS-2487424745,8/2/2018,debit,20-30,2018,8,2,Thursday,52855.65
26,9.47,931.76,CUS-2487424745,8/2/2018,debit,20-30,2018,8,2,Thursday,52855.65
26,195,736.76,CUS-2487424745,8/3/2018,debit,20-30,2018,8,3,Friday,52855.65
26,15.3,721.46,CUS-2487424745,8/3/2018,debit,20-30,2018,8,3,Friday,52855.65
26,8.99,712.47,CUS-2487424745,8/3/2018,debit,20-30,2018,8,3,Friday,52855.65
26,7.61,704.86,CUS-2487424745,8/3/2018,debit,20-30,2018,8,3,Friday,52855.65
26,2.08,702.78,CUS-2487424745,8/3/2018,debit,20-30,2018,8,3,Friday,52855.65
26,11.29,691.49,CUS-2487424745,8/3/2018,debit,20-30,2018,8,3,Friday,52855.65
26,11.28,680.21,CUS-2487424745,8/3/2018,debit,20-30,2018,8,3,Friday,52855.65
26,21.58,658.63,CUS-2487424745,8/3/2018,debit,20-30,2018,8,3,Friday,52855.65
26,3.48,655.15,CUS-2487424745,8/3/2018,debit,20-30,2018,8,3,Friday,52855.65
26,45.05,610.1,CUS-2487424745,8/3/2018,debit,20-30,2018,8,3,Friday,52855.65
26,22.23,587.87,CUS-2487424745,8/4/2018,debit,20-30,2018,8,4,Saturday,52855.65
26,30.44,557.43,CUS-2487424745,8/4/2018,debit,20-30,2018,8,4,Saturday,52855.65
26,11.22,546.21,CUS-2487424745,8/4/2018,debit,20-30,2018,8,4,Saturday,52855.65
26,7.59,538.62,CUS-2487424745,8/4/2018,debit,20-30,2018,8,4,Saturday,52855.65
26,2,536.62,CUS-2487424745,8/4/2018,debit,20-30,2018,8,4,Saturday,52855.65
26,8.09,528.53,CUS-2487424745,8/4/2018,debit,20-30,2018,8,4,Saturday,52855.65
26,11.48,517.05,CUS-2487424745,8/5/2018,debit,20-30,2018,8,5,Sunday,52855.65
26,2.85,514.2,CUS-2487424745,8/5/2018,debit,20-30,2018,8,5,Sunday,52855.65
26,7.54,506.66,CUS-2487424745,8/5/2018,debit,20-30,2018,8,5,Sunday,52855.65
26,17.71,488.95,CUS-2487424745,8/5/2018,debit,20-30,2018,8,5,Sunday,52855.65
26,33.82,455.13,CUS-2487424745,8/6/2018,debit,20-30,2018,8,6,Monday,52855.65
26,9.76,445.37,CUS-2487424745,8/6/2018,debit,20-30,2018,8,6,Monday,52855.65
26,20,425.37,CUS-2487424745,8/7/2018,debit,20-30,2018,8,7,Tuesday,52855.65
26,36,389.37,CUS-2487424745,8/7/2018,debit,20-30,2018,8,7,Tuesday,52855.65
26,11.14,378.23,CUS-2487424745,8/7/2018,debit,20-30,2018,8,7,Tuesday,52855.65
26,7.85,370.38,CUS-2487424745,8/7/2018,debit,20-30,2018,8,7,Tuesday,52855.65
26,9.43,360.95,CUS-2487424745,8/7/2018,debit,20-30,2018,8,7,Tuesday,52855.65
26,5.55,355.4,CUS-2487424745,8/7/2018,debit,20-30,2018,8,7,Tuesday,52855.65
26,2.49,352.91,CUS-2487424745,8/7/2018,debit,20-30,2018,8,7,Tuesday,52855.65
26,11.27,341.64,CUS-2487424745,8/7/2018,debit,20-30,2018,8,7,Tuesday,52855.65
26,8.4,333.24,CUS-2487424745,8/7/2018,debit,20-30,2018,8,7,Tuesday,52855.65
26,3.26,329.98,CUS-2487424745,8/7/2018,debit,20-30,2018,8,7,Tuesday,52855.65
26,7.57,1336.08,CUS-2487424745,8/8/2018,debit,20-30,2018,8,8,Wednesday,52855.65
26,5.81,1330.27,CUS-2487424745,8/9/2018,debit,20-30,2018,8,9,Thursday,52855.65
26,19.58,1310.69,CUS-2487424745,8/9/2018,debit,20-30,2018,8,9,Thursday,52855.65
26,92,1218.69,CUS-2487424745,8/9/2018,debit,20-30,2018,8,9,Thursday,52855.65
26,9.67,1209.02,CUS-2487424745,8/9/2018,debit,20-30,2018,8,9,Thursday,52855.65
26,3.01,1206.01,CUS-2487424745,8/9/2018,debit,20-30,2018,8,9,Thursday,52855.65
26,4.03,1201.98,CUS-2487424745,8/9/2018,debit,20-30,2018,8,9,Thursday,52855.65
26,4.02,1197.96,CUS-2487424745,8/10/2018,debit,20-30,2018,8,10,Friday,52855.65
26,6.38,1191.58,CUS-2487424745,8/10/2018,debit,20-30,2018,8,10,Friday,52855.65
26,9.4,1182.18,CUS-2487424745,8/10/2018,debit,20-30,2018,8,10,Friday,52855.65
26,8.83,1173.35,CUS-2487424745,8/10/2018,debit,20-30,2018,8,10,Friday,52855.65
26,5.34,1168.01,CUS-2487424745,8/10/2018,debit,20-30,2018,8,10,Friday,52855.65
26,6.59,1161.42,CUS-2487424745,8/10/2018,debit,20-30,2018,8,10,Friday,52855.65
26,9.15,1152.27,CUS-2487424745,8/10/2018,debit,20-30,2018,8,10,Friday,52855.65
26,3.01,1149.26,CUS-2487424745,8/10/2018,debit,20-30,2018,8,10,Friday,52855.65
26,8.91,1140.35,CUS-2487424745,8/10/2018,debit,20-30,2018,8,10,Friday,52855.65
26,6.9,1133.45,CUS-2487424745,8/10/2018,debit,20-30,2018,8,10,Friday,52855.65
26,13.21,1120.24,CUS-2487424745,8/10/2018,debit,20-30,2018,8,10,Friday,52855.65
26,6.31,1113.93,CUS-2487424745,8/11/2018,debit,20-30,2018,8,11,Saturday,52855.65
26,10.62,1103.31,CUS-2487424745,8/11/2018,debit,20-30,2018,8,11,Saturday,52855.65
26,11.65,1091.66,CUS-2487424745,8/11/2018,debit,20-30,2018,8,11,Saturday,52855.65
26,8.61,1083.05,CUS-2487424745,8/11/2018,debit,20-30,2018,8,11,Saturday,52855.65
26,14.17,1068.88,CUS-2487424745,8/11/2018,debit,20-30,2018,8,11,Saturday,52855.65
26,19.64,1049.24,CUS-2487424745,8/11/2018,debit,20-30,2018,8,11,Saturday,52855.65
26,6.51,1042.73,CUS-2487424745,8/11/2018,debit,20-30,2018,8,11,Saturday,52855.65
26,14.86,1027.87,CUS-2487424745,8/11/2018,debit,20-30,2018,8,11,Saturday,52855.65
26,209.16,818.71,CUS-2487424745,8/12/2018,debit,20-30,2018,8,12,Sunday,52855.65
26,4.88,813.83,CUS-2487424745,8/12/2018,debit,20-30,2018,8,12,Sunday,52855.65
26,9.87,803.96,CUS-2487424745,8/12/2018,debit,20-30,2018,8,12,Sunday,52855.65
26,6.01,797.95,CUS-2487424745,8/12/2018,debit,20-30,2018,8,12,Sunday,52855.65
26,2.89,795.06,CUS-2487424745,8/12/2018,debit,20-30,2018,8,12,Sunday,52855.65
26,43.91,751.15,CUS-2487424745,8/12/2018,debit,20-30,2018,8,12,Sunday,52855.65
26,7.49,743.66,CUS-2487424745,8/12/2018,debit,20-30,2018,8,12,Sunday,52855.65
26,14.46,729.2,CUS-2487424745,8/13/2018,debit,20-30,2018,8,13,Monday,52855.65
26,16.77,712.43,CUS-2487424745,8/13/2018,debit,20-30,2018,8,13,Monday,52855.65
26,32.99,679.44,CUS-2487424745,8/13/2018,debit,20-30,2018,8,13,Monday,52855.65
26,11.61,667.83,CUS-2487424745,8/13/2018,debit,20-30,2018,8,13,Monday,52855.65
26,6.97,660.86,CUS-2487424745,8/13/2018,debit,20-30,2018,8,13,Monday,52855.65
26,42,618.86,CUS-2487424745,8/13/2018,debit,20-30,2018,8,13,Monday,52855.65
26,5.67,613.19,CUS-2487424745,8/13/2018,debit,20-30,2018,8,13,Monday,52855.65
26,11.24,601.95,CUS-2487424745,8/13/2018,debit,20-30,2018,8,13,Monday,52855.65
26,12.64,589.31,CUS-2487424745,8/13/2018,debit,20-30,2018,8,13,Monday,52855.65
26,3.55,585.76,CUS-2487424745,8/13/2018,debit,20-30,2018,8,13,Monday,52855.65
26,6.44,579.32,CUS-2487424745,8/13/2018,debit,20-30,2018,8,13,Monday,52855.65
26,20,559.32,CUS-2487424745,8/14/2018,debit,20-30,2018,8,14,Tuesday,52855.65
26,36,523.32,CUS-2487424745,8/14/2018,debit,20-30,2018,8,14,Tuesday,52855.65
26,15.09,508.23,CUS-2487424745,8/14/2018,debit,20-30,2018,8,14,Tuesday,52855.65
26,10.56,497.67,CUS-2487424745,8/14/2018,debit,20-30,2018,8,14,Tuesday,52855.65
26,71.12,426.55,CUS-2487424745,8/14/2018,debit,20-30,2018,8,14,Tuesday,52855.65
26,7.7,1432.52,CUS-2487424745,8/15/2018,debit,20-30,2018,8,15,Wednesday,52855.65
26,7.71,1424.81,CUS-2487424745,8/15/2018,debit,20-30,2018,8,15,Wednesday,52855.65
26,17.75,1407.06,CUS-2487424745,8/15/2018,debit,20-30,2018,8,15,Wednesday,52855.65
26,27.19,1379.87,CUS-2487424745,8/15/2018,debit,20-30,2018,8,15,Wednesday,52855.65
26,35.91,1256.01,CUS-2487424745,8/17/2018,debit,20-30,2018,8,17,Friday,52855.65
26,5.12,1250.89,CUS-2487424745,8/17/2018,debit,20-30,2018,8,17,Friday,52855.65
26,5.14,1245.75,CUS-2487424745,8/17/2018,debit,20-30,2018,8,17,Friday,52855.65
26,22.3,1223.45,CUS-2487424745,8/18/2018,debit,20-30,2018,8,18,Saturday,52855.65
26,6.15,1217.3,CUS-2487424745,8/18/2018,debit,20-30,2018,8,18,Saturday,52855.65
26,35.03,1182.27,CUS-2487424745,8/18/2018,debit,20-30,2018,8,18,Saturday,52855.65
26,6.13,1176.14,CUS-2487424745,8/18/2018,debit,20-30,2018,8,18,Saturday,52855.65
26,14.11,1162.03,CUS-2487424745,8/18/2018,debit,20-30,2018,8,18,Saturday,52855.65
26,16.68,1145.35,CUS-2487424745,8/19/2018,debit,20-30,2018,8,19,Sunday,52855.65
26,16.84,1128.51,CUS-2487424745,8/19/2018,debit,20-30,2018,8,19,Sunday,52855.65
26,15.6,1112.91,CUS-2487424745,8/19/2018,debit,20-30,2018,8,19,Sunday,52855.65
26,4.79,1108.12,CUS-2487424745,8/19/2018,debit,20-30,2018,8,19,Sunday,52855.65
26,4.11,1104.01,CUS-2487424745,8/19/2018,debit,20-30,2018,8,19,Sunday,52855.65
26,5.46,1098.55,CUS-2487424745,8/19/2018,debit,20-30,2018,8,19,Sunday,52855.65
26,13.03,1085.52,CUS-2487424745,8/19/2018,debit,20-30,2018,8,19,Sunday,52855.65
26,9.12,1076.4,CUS-2487424745,8/20/2018,debit,20-30,2018,8,20,Monday,52855.65
26,8.34,1068.06,CUS-2487424745,8/20/2018,debit,20-30,2018,8,20,Monday,52855.65
26,6,1062.06,CUS-2487424745,8/20/2018,debit,20-30,2018,8,20,Monday,52855.65
26,20,1042.06,CUS-2487424745,8/21/2018,debit,20-30,2018,8,21,Tuesday,52855.65
26,36,1006.06,CUS-2487424745,8/21/2018,debit,20-30,2018,8,21,Tuesday,52855.65
26,30.58,975.48,CUS-2487424745,8/21/2018,debit,20-30,2018,8,21,Tuesday,52855.65
26,4.33,971.15,CUS-2487424745,8/21/2018,debit,20-30,2018,8,21,Tuesday,52855.65
26,5.35,965.8,CUS-2487424745,8/22/2018,debit,20-30,2018,8,22,Wednesday,52855.65
26,7.6,958.2,CUS-2487424745,8/22/2018,debit,20-30,2018,8,22,Wednesday,52855.65
26,10.96,947.24,CUS-2487424745,8/22/2018,debit,20-30,2018,8,22,Wednesday,52855.65
26,7.94,939.3,CUS-2487424745,8/22/2018,debit,20-30,2018,8,22,Wednesday,52855.65
26,20.91,918.39,CUS-2487424745,8/22/2018,debit,20-30,2018,8,22,Wednesday,52855.65
26,12.8,1919.26,CUS-2487424745,8/22/2018,debit,20-30,2018,8,22,Wednesday,52855.65
26,51.04,1868.22,CUS-2487424745,8/23/2018,debit,20-30,2018,8,23,Thursday,52855.65
26,14.15,1854.07,CUS-2487424745,8/24/2018,debit,20-30,2018,8,24,Friday,52855.65
26,12.32,1841.75,CUS-2487424745,8/24/2018,debit,20-30,2018,8,24,Friday,52855.65
26,14.95,1826.8,CUS-2487424745,8/24/2018,debit,20-30,2018,8,24,Friday,52855.65
26,6.81,1819.99,CUS-2487424745,8/24/2018,debit,20-30,2018,8,24,Friday,52855.65
26,11.58,1808.41,CUS-2487424745,8/24/2018,debit,20-30,2018,8,24,Friday,52855.65
26,14.37,1794.04,CUS-2487424745,8/24/2018,debit,20-30,2018,8,24,Friday,52855.65
26,9.67,1784.37,CUS-2487424745,8/24/2018,debit,20-30,2018,8,24,Friday,52855.65
26,5.87,1778.5,CUS-2487424745,8/24/2018,debit,20-30,2018,8,24,Friday,52855.65
26,8.33,1770.17,CUS-2487424745,8/24/2018,debit,20-30,2018,8,24,Friday,52855.65
26,17.59,1752.58,CUS-2487424745,8/24/2018,debit,20-30,2018,8,24,Friday,52855.65
26,27.27,1725.31,CUS-2487424745,8/24/2018,debit,20-30,2018,8,24,Friday,52855.65
26,8.64,1716.67,CUS-2487424745,8/25/2018,debit,20-30,2018,8,25,Saturday,52855.65
26,19.31,1697.36,CUS-2487424745,8/25/2018,debit,20-30,2018,8,25,Saturday,52855.65
26,26.5,1670.86,CUS-2487424745,8/25/2018,debit,20-30,2018,8,25,Saturday,52855.65
26,6.52,1664.34,CUS-2487424745,8/25/2018,debit,20-30,2018,8,25,Saturday,52855.65
26,8.87,1655.47,CUS-2487424745,8/25/2018,debit,20-30,2018,8,25,Saturday,52855.65
26,9.68,1645.79,CUS-2487424745,8/25/2018,debit,20-30,2018,8,25,Saturday,52855.65
26,8.17,1637.62,CUS-2487424745,8/26/2018,debit,20-30,2018,8,26,Sunday,52855.65
26,90.43,1547.19,CUS-2487424745,8/26/2018,debit,20-30,2018,8,26,Sunday,52855.65
26,9.67,1537.52,CUS-2487424745,8/26/2018,debit,20-30,2018,8,26,Sunday,52855.65
26,11.55,1525.97,CUS-2487424745,8/26/2018,debit,20-30,2018,8,26,Sunday,52855.65
26,18.7,1507.27,CUS-2487424745,8/26/2018,debit,20-30,2018,8,26,Sunday,52855.65
26,6.52,1500.75,CUS-2487424745,8/26/2018,debit,20-30,2018,8,26,Sunday,52855.65
26,12.14,1488.61,CUS-2487424745,8/26/2018,debit,20-30,2018,8,26,Sunday,52855.65
26,11.1,1477.51,CUS-2487424745,8/26/2018,debit,20-30,2018,8,26,Sunday,52855.65
26,9.44,1468.07,CUS-2487424745,8/26/2018,debit,20-30,2018,8,26,Sunday,52855.65
26,7.45,1460.62,CUS-2487424745,8/26/2018,debit,20-30,2018,8,26,Sunday,52855.65
26,12.46,1448.16,CUS-2487424745,8/26/2018,debit,20-30,2018,8,26,Sunday,52855.65
26,5.06,1443.1,CUS-2487424745,8/26/2018,debit,20-30,2018,8,26,Sunday,52855.65
26,3.75,1439.35,CUS-2487424745,8/27/2018,debit,20-30,2018,8,27,Monday,52855.65
26,3.95,1435.4,CUS-2487424745,8/27/2018,debit,20-30,2018,8,27,Monday,52855.65
26,21,1414.4,CUS-2487424745,8/27/2018,debit,20-30,2018,8,27,Monday,52855.65
26,20,1394.4,CUS-2487424745,8/28/2018,debit,20-30,2018,8,28,Tuesday,52855.65
26,36,1358.4,CUS-2487424745,8/28/2018,debit,20-30,2018,8,28,Tuesday,52855.65
26,9.73,1348.67,CUS-2487424745,8/28/2018,debit,20-30,2018,8,28,Tuesday,52855.65
26,20.58,1328.09,CUS-2487424745,8/28/2018,debit,20-30,2018,8,28,Tuesday,52855.65
26,6.76,1321.33,CUS-2487424745,8/28/2018,debit,20-30,2018,8,28,Tuesday,52855.65
26,21.2,1300.13,CUS-2487424745,8/29/2018,debit,20-30,2018,8,29,Wednesday,52855.65
26,1.59,1298.54,CUS-2487424745,8/29/2018,debit,20-30,2018,8,29,Wednesday,52855.65
26,7.09,1291.45,CUS-2487424745,8/29/2018,debit,20-30,2018,8,29,Wednesday,52855.65
26,10.7,1280.75,CUS-2487424745,8/29/2018,debit,20-30,2018,8,29,Wednesday,52855.65
26,12.69,1268.06,CUS-2487424745,8/29/2018,debit,20-30,2018,8,29,Wednesday,52855.65
26,7.76,1260.3,CUS-2487424745,8/29/2018,debit,20-30,2018,8,29,Wednesday,52855.65
26,11.93,2262.04,CUS-2487424745,8/29/2018,debit,20-30,2018,8,29,Wednesday,52855.65
26,24.32,2237.72,CUS-2487424745,8/29/2018,debit,20-30,2018,8,29,Wednesday,52855.65
26,3.35,2234.37,CUS-2487424745,8/29/2018,debit,20-30,2018,8,29,Wednesday,52855.65
26,5.32,2229.05,CUS-2487424745,8/29/2018,debit,20-30,2018,8,29,Wednesday,52855.65
26,10.91,2218.14,CUS-2487424745,8/29/2018,debit,20-30,2018,8,29,Wednesday,52855.65
26,573.66,1644.48,CUS-2487424745,8/29/2018,debit,20-30,2018,8,29,Wednesday,52855.65
26,17.28,1627.2,CUS-2487424745,8/29/2018,debit,20-30,2018,8,29,Wednesday,52855.65
26,7.56,1619.64,CUS-2487424745,8/31/2018,debit,20-30,2018,8,31,Friday,52855.65
26,9.15,1610.49,CUS-2487424745,8/31/2018,debit,20-30,2018,8,31,Friday,52855.65
26,9.43,1601.06,CUS-2487424745,8/31/2018,debit,20-30,2018,8,31,Friday,52855.65
26,11.25,1589.81,CUS-2487424745,8/31/2018,debit,20-30,2018,8,31,Friday,52855.65
26,4.66,1585.15,CUS-2487424745,8/31/2018,debit,20-30,2018,8,31,Friday,52855.65
26,2.4,1582.75,CUS-2487424745,9/1/2018,debit,20-30,2018,9,1,Saturday,52855.65
26,24.88,1557.87,CUS-2487424745,9/1/2018,debit,20-30,2018,9,1,Saturday,52855.65
26,14.77,1543.1,CUS-2487424745,9/1/2018,debit,20-30,2018,9,1,Saturday,52855.65
26,70.22,1472.88,CUS-2487424745,9/1/2018,debit,20-30,2018,9,1,Saturday,52855.65
26,7.51,1465.37,CUS-2487424745,9/2/2018,debit,20-30,2018,9,2,Sunday,52855.65
26,6.27,1459.1,CUS-2487424745,9/2/2018,debit,20-30,2018,9,2,Sunday,52855.65
26,4.28,1454.82,CUS-2487424745,9/2/2018,debit,20-30,2018,9,2,Sunday,52855.65
26,8.46,1446.36,CUS-2487424745,9/2/2018,debit,20-30,2018,9,2,Sunday,52855.65
26,12.15,1434.21,CUS-2487424745,9/2/2018,debit,20-30,2018,9,2,Sunday,52855.65
26,195,1239.21,CUS-2487424745,9/3/2018,debit,20-30,2018,9,3,Monday,52855.65
26,20,1219.21,CUS-2487424745,9/4/2018,debit,20-30,2018,9,4,Tuesday,52855.65
26,36,1183.21,CUS-2487424745,9/4/2018,debit,20-30,2018,9,4,Tuesday,52855.65
26,3.86,1179.35,CUS-2487424745,9/5/2018,debit,20-30,2018,9,5,Wednesday,52855.65
26,24.31,1155.04,CUS-2487424745,9/5/2018,debit,20-30,2018,9,5,Wednesday,52855.65
26,10.39,1144.65,CUS-2487424745,9/5/2018,debit,20-30,2018,9,5,Wednesday,52855.65
26,12.57,1132.08,CUS-2487424745,9/5/2018,debit,20-30,2018,9,5,Wednesday,52855.65
26,30.71,2115.04,CUS-2487424745,9/5/2018,debit,20-30,2018,9,5,Wednesday,52855.65
26,14.19,2100.85,CUS-2487424745,9/5/2018,debit,20-30,2018,9,5,Wednesday,52855.65
26,12.98,2087.87,CUS-2487424745,9/6/2018,debit,20-30,2018,9,6,Thursday,52855.65
26,23.84,2064.03,CUS-2487424745,9/6/2018,debit,20-30,2018,9,6,Thursday,52855.65
26,23.81,2040.22,CUS-2487424745,9/6/2018,debit,20-30,2018,9,6,Thursday,52855.65
26,17.71,2022.51,CUS-2487424745,9/6/2018,debit,20-30,2018,9,6,Thursday,52855.65
26,7.9,2014.61,CUS-2487424745,9/6/2018,debit,20-30,2018,9,6,Thursday,52855.65
26,23.67,1990.94,CUS-2487424745,9/6/2018,debit,20-30,2018,9,6,Thursday,52855.65
26,8.97,1981.97,CUS-2487424745,9/6/2018,debit,20-30,2018,9,6,Thursday,52855.65
26,8.71,1973.26,CUS-2487424745,9/7/2018,debit,20-30,2018,9,7,Friday,52855.65
26,17.79,1955.47,CUS-2487424745,9/7/2018,debit,20-30,2018,9,7,Friday,52855.65
26,13.31,1942.16,CUS-2487424745,9/7/2018,debit,20-30,2018,9,7,Friday,52855.65
26,3.32,1938.84,CUS-2487424745,9/7/2018,debit,20-30,2018,9,7,Friday,52855.65
26,5.58,1933.26,CUS-2487424745,9/7/2018,debit,20-30,2018,9,7,Friday,52855.65
26,10.58,1922.68,CUS-2487424745,9/7/2018,debit,20-30,2018,9,7,Friday,52855.65
26,6.12,1916.56,CUS-2487424745,9/7/2018,debit,20-30,2018,9,7,Friday,52855.65
26,10.39,1906.17,CUS-2487424745,9/8/2018,debit,20-30,2018,9,8,Saturday,52855.65
26,6.55,1899.62,CUS-2487424745,9/8/2018,debit,20-30,2018,9,8,Saturday,52855.65
26,10.7,1888.92,CUS-2487424745,9/8/2018,debit,20-30,2018,9,8,Saturday,52855.65
26,11.75,1877.17,CUS-2487424745,9/8/2018,debit,20-30,2018,9,8,Saturday,52855.65
26,19.75,1857.42,CUS-2487424745,9/8/2018,debit,20-30,2018,9,8,Saturday,52855.65
26,14.69,1842.73,CUS-2487424745,9/9/2018,debit,20-30,2018,9,9,Sunday,52855.65
26,6.45,1836.28,CUS-2487424745,9/9/2018,debit,20-30,2018,9,9,Sunday,52855.65
26,97.24,1739.04,CUS-2487424745,9/9/2018,debit,20-30,2018,9,9,Sunday,52855.65
26,18.4,1720.64,CUS-2487424745,9/9/2018,debit,20-30,2018,9,9,Sunday,52855.65
26,6.69,1713.95,CUS-2487424745,9/9/2018,debit,20-30,2018,9,9,Sunday,52855.65
26,92,1621.95,CUS-2487424745,9/9/2018,debit,20-30,2018,9,9,Sunday,52855.65
26,17.67,1604.28,CUS-2487424745,9/9/2018,debit,20-30,2018,9,9,Sunday,52855.65
26,17.37,1586.91,CUS-2487424745,9/9/2018,debit,20-30,2018,9,9,Sunday,52855.65
26,6.15,1580.76,CUS-2487424745,9/10/2018,debit,20-30,2018,9,10,Monday,52855.65
26,14.96,1565.8,CUS-2487424745,9/10/2018,debit,20-30,2018,9,10,Monday,52855.65
26,6.76,1559.04,CUS-2487424745,9/10/2018,debit,20-30,2018,9,10,Monday,52855.65
26,20,1539.04,CUS-2487424745,9/11/2018,debit,20-30,2018,9,11,Tuesday,52855.65
26,36,1503.04,CUS-2487424745,9/11/2018,debit,20-30,2018,9,11,Tuesday,52855.65
26,8.86,1494.18,CUS-2487424745,9/11/2018,debit,20-30,2018,9,11,Tuesday,52855.65
26,6.97,1487.21,CUS-2487424745,9/11/2018,debit,20-30,2018,9,11,Tuesday,52855.65
26,22.7,1464.51,CUS-2487424745,9/11/2018,debit,20-30,2018,9,11,Tuesday,52855.65
26,10.34,1454.17,CUS-2487424745,9/11/2018,debit,20-30,2018,9,11,Tuesday,52855.65
26,8.11,1446.06,CUS-2487424745,9/11/2018,debit,20-30,2018,9,11,Tuesday,52855.65
26,28.74,1417.32,CUS-2487424745,9/11/2018,debit,20-30,2018,9,11,Tuesday,52855.65
26,14.86,1402.46,CUS-2487424745,9/11/2018,debit,20-30,2018,9,11,Tuesday,52855.65
26,0.76,1401.7,CUS-2487424745,9/12/2018,debit,20-30,2018,9,12,Wednesday,52855.65
26,25.09,1376.61,CUS-2487424745,9/12/2018,debit,20-30,2018,9,12,Wednesday,52855.65
26,7.65,1368.96,CUS-2487424745,9/12/2018,debit,20-30,2018,9,12,Wednesday,52855.65
26,6.48,1362.48,CUS-2487424745,9/12/2018,debit,20-30,2018,9,12,Wednesday,52855.65
26,13.54,1348.94,CUS-2487424745,9/12/2018,debit,20-30,2018,9,12,Wednesday,52855.65
26,21.35,1327.59,CUS-2487424745,9/12/2018,debit,20-30,2018,9,12,Wednesday,52855.65
26,7.75,2333.51,CUS-2487424745,9/13/2018,debit,20-30,2018,9,13,Thursday,52855.65
26,7.39,2326.12,CUS-2487424745,9/13/2018,debit,20-30,2018,9,13,Thursday,52855.65
26,12.4,2313.72,CUS-2487424745,9/13/2018,debit,20-30,2018,9,13,Thursday,52855.65
26,11.42,2302.3,CUS-2487424745,9/13/2018,debit,20-30,2018,9,13,Thursday,52855.65
26,4.63,2297.67,CUS-2487424745,9/13/2018,debit,20-30,2018,9,13,Thursday,52855.65
26,33.11,2264.56,CUS-2487424745,9/13/2018,debit,20-30,2018,9,13,Thursday,52855.65
26,10.74,2253.82,CUS-2487424745,9/14/2018,debit,20-30,2018,9,14,Friday,52855.65
26,11.43,2242.39,CUS-2487424745,9/14/2018,debit,20-30,2018,9,14,Friday,52855.65
26,9.14,2233.25,CUS-2487424745,9/14/2018,debit,20-30,2018,9,14,Friday,52855.65
26,5.83,2227.42,CUS-2487424745,9/14/2018,debit,20-30,2018,9,14,Friday,52855.65
26,11.9,2215.52,CUS-2487424745,9/14/2018,debit,20-30,2018,9,14,Friday,52855.65
26,20.22,2195.3,CUS-2487424745,9/14/2018,debit,20-30,2018,9,14,Friday,52855.65
26,14.28,2181.02,CUS-2487424745,9/14/2018,debit,20-30,2018,9,14,Friday,52855.65
26,8.11,2172.91,CUS-2487424745,9/14/2018,debit,20-30,2018,9,14,Friday,52855.65
26,4.66,2168.25,CUS-2487424745,9/14/2018,debit,20-30,2018,9,14,Friday,52855.65
26,7.33,2160.92,CUS-2487424745,9/14/2018,debit,20-30,2018,9,14,Friday,52855.65
26,11.52,2149.4,CUS-2487424745,9/14/2018,debit,20-30,2018,9,14,Friday,52855.65
26,13.1,2136.3,CUS-2487424745,9/15/2018,debit,20-30,2018,9,15,Saturday,52855.65
26,26.47,2109.83,CUS-2487424745,9/15/2018,debit,20-30,2018,9,15,Saturday,52855.65
26,5.72,2104.11,CUS-2487424745,9/15/2018,debit,20-30,2018,9,15,Saturday,52855.65
26,6.54,2097.57,CUS-2487424745,9/16/2018,debit,20-30,2018,9,16,Sunday,52855.65
26,12.65,2084.92,CUS-2487424745,9/16/2018,debit,20-30,2018,9,16,Sunday,52855.65
26,16.79,2068.13,CUS-2487424745,9/16/2018,debit,20-30,2018,9,16,Sunday,52855.65
26,12.05,2056.08,CUS-2487424745,9/16/2018,debit,20-30,2018,9,16,Sunday,52855.65
26,13.51,2042.57,CUS-2487424745,9/16/2018,debit,20-30,2018,9,16,Sunday,52855.65
26,20.55,2022.02,CUS-2487424745,9/16/2018,debit,20-30,2018,9,16,Sunday,52855.65
26,7.44,2014.58,CUS-2487424745,9/16/2018,debit,20-30,2018,9,16,Sunday,52855.65
26,22.36,1992.22,CUS-2487424745,9/16/2018,debit,20-30,2018,9,16,Sunday,52855.65
26,3.67,1988.55,CUS-2487424745,9/16/2018,debit,20-30,2018,9,16,Sunday,52855.65
26,38.94,1949.61,CUS-2487424745,9/17/2018,debit,20-30,2018,9,17,Monday,52855.65
26,11.33,1938.28,CUS-2487424745,9/17/2018,debit,20-30,2018,9,17,Monday,52855.65
26,11.46,1926.82,CUS-2487424745,9/17/2018,debit,20-30,2018,9,17,Monday,52855.65
26,16.55,1910.27,CUS-2487424745,9/17/2018,debit,20-30,2018,9,17,Monday,52855.65
26,4.98,1905.29,CUS-2487424745,9/17/2018,debit,20-30,2018,9,17,Monday,52855.65
26,20,1885.29,CUS-2487424745,9/18/2018,debit,20-30,2018,9,18,Tuesday,52855.65
26,36,1834.44,CUS-2487424745,9/18/2018,debit,20-30,2018,9,18,Tuesday,52855.65
26,14.85,1870.44,CUS-2487424745,9/18/2018,debit,20-30,2018,9,18,Tuesday,52855.65
26,58.31,1776.13,CUS-2487424745,9/18/2018,debit,20-30,2018,9,18,Tuesday,52855.65
26,10.8,1765.33,CUS-2487424745,9/18/2018,debit,20-30,2018,9,18,Tuesday,52855.65
26,14.13,1751.2,CUS-2487424745,9/18/2018,debit,20-30,2018,9,18,Tuesday,52855.65
26,5,1746.2,CUS-2487424745,9/18/2018,debit,20-30,2018,9,18,Tuesday,52855.65
26,5.61,1740.59,CUS-2487424745,9/18/2018,debit,20-30,2018,9,18,Tuesday,52855.65
26,10.83,1729.76,CUS-2487424745,9/18/2018,debit,20-30,2018,9,18,Tuesday,52855.65
26,2.28,1727.48,CUS-2487424745,9/18/2018,debit,20-30,2018,9,18,Tuesday,52855.65
26,7.93,1719.55,CUS-2487424745,9/18/2018,debit,20-30,2018,9,18,Tuesday,52855.65
26,5.79,1713.76,CUS-2487424745,9/19/2018,debit,20-30,2018,9,19,Wednesday,52855.65
26,9.53,2717.9,CUS-2487424745,9/22/2018,debit,20-30,2018,9,22,Saturday,52855.65
26,8.44,2709.46,CUS-2487424745,9/22/2018,debit,20-30,2018,9,22,Saturday,52855.65
26,6.4,2703.06,CUS-2487424745,9/22/2018,debit,20-30,2018,9,22,Saturday,52855.65
26,8.08,2694.98,CUS-2487424745,9/22/2018,debit,20-30,2018,9,22,Saturday,52855.65
26,11.77,2683.21,CUS-2487424745,9/22/2018,debit,20-30,2018,9,22,Saturday,52855.65
26,9.6,2673.61,CUS-2487424745,9/22/2018,debit,20-30,2018,9,22,Saturday,52855.65
26,8.22,2665.39,CUS-2487424745,9/22/2018,debit,20-30,2018,9,22,Saturday,52855.65
26,6.52,2658.87,CUS-2487424745,9/22/2018,debit,20-30,2018,9,22,Saturday,52855.65
26,5.35,2653.52,CUS-2487424745,9/22/2018,debit,20-30,2018,9,22,Saturday,52855.65
26,23.04,2630.48,CUS-2487424745,9/22/2018,debit,20-30,2018,9,22,Saturday,52855.65
26,12.87,2617.61,CUS-2487424745,9/22/2018,debit,20-30,2018,9,22,Saturday,52855.65
26,11.81,2605.8,CUS-2487424745,9/22/2018,debit,20-30,2018,9,22,Saturday,52855.65
26,16.12,2589.68,CUS-2487424745,9/23/2018,debit,20-30,2018,9,23,Sunday,52855.65
26,9.98,2579.7,CUS-2487424745,9/23/2018,debit,20-30,2018,9,23,Sunday,52855.65
26,15.98,2563.72,CUS-2487424745,9/23/2018,debit,20-30,2018,9,23,Sunday,52855.65
26,18.08,2545.64,CUS-2487424745,9/23/2018,debit,20-30,2018,9,23,Sunday,52855.65
26,19.99,2525.65,CUS-2487424745,9/23/2018,debit,20-30,2018,9,23,Sunday,52855.65
26,15.39,2510.26,CUS-2487424745,9/23/2018,debit,20-30,2018,9,23,Sunday,52855.65
26,16.2,2494.06,CUS-2487424745,9/23/2018,debit,20-30,2018,9,23,Sunday,52855.65
26,2.63,2491.43,CUS-2487424745,9/23/2018,debit,20-30,2018,9,23,Sunday,52855.65
26,11.68,2479.75,CUS-2487424745,9/23/2018,debit,20-30,2018,9,23,Sunday,52855.65
26,13.59,2466.16,CUS-2487424745,9/23/2018,debit,20-30,2018,9,23,Sunday,52855.65
26,22.99,2443.17,CUS-2487424745,9/24/2018,debit,20-30,2018,9,24,Monday,52855.65
26,10.31,2432.86,CUS-2487424745,9/24/2018,debit,20-30,2018,9,24,Monday,52855.65
26,6.74,2426.12,CUS-2487424745,9/24/2018,debit,20-30,2018,9,24,Monday,52855.65
26,12.32,2413.8,CUS-2487424745,9/24/2018,debit,20-30,2018,9,24,Monday,52855.65
26,20,2393.8,CUS-2487424745,9/25/2018,debit,20-30,2018,9,25,Tuesday,52855.65
26,6.21,2387.59,CUS-2487424745,9/25/2018,debit,20-30,2018,9,25,Tuesday,52855.65
26,36,2351.59,CUS-2487424745,9/25/2018,debit,20-30,2018,9,25,Tuesday,52855.65
26,7.19,3358.07,CUS-2487424745,9/27/2018,debit,20-30,2018,9,27,Thursday,52855.65
26,11.28,3346.79,CUS-2487424745,9/27/2018,debit,20-30,2018,9,27,Thursday,52855.65
26,9.92,3336.87,CUS-2487424745,9/27/2018,debit,20-30,2018,9,27,Thursday,52855.65
26,18.51,3318.36,CUS-2487424745,9/27/2018,debit,20-30,2018,9,27,Thursday,52855.65
26,25.92,3292.44,CUS-2487424745,9/27/2018,debit,20-30,2018,9,27,Thursday,52855.65
26,16.78,3275.66,CUS-2487424745,9/27/2018,debit,20-30,2018,9,27,Thursday,52855.65
26,8.25,3267.41,CUS-2487424745,9/27/2018,debit,20-30,2018,9,27,Thursday,52855.65
26,7.61,3259.8,CUS-2487424745,9/28/2018,debit,20-30,2018,9,28,Friday,52855.65
26,4.89,3254.91,CUS-2487424745,9/28/2018,debit,20-30,2018,9,28,Friday,52855.65
26,16.73,3238.18,CUS-2487424745,9/28/2018,debit,20-30,2018,9,28,Friday,52855.65
26,10.99,3227.19,CUS-2487424745,9/28/2018,debit,20-30,2018,9,28,Friday,52855.65
26,9.68,3217.51,CUS-2487424745,9/28/2018,debit,20-30,2018,9,28,Friday,52855.65
26,5.71,3211.8,CUS-2487424745,9/28/2018,debit,20-30,2018,9,28,Friday,52855.65
26,6.21,3205.59,CUS-2487424745,9/28/2018,debit,20-30,2018,9,28,Friday,52855.65
26,6.89,3198.7,CUS-2487424745,9/28/2018,debit,20-30,2018,9,28,Friday,52855.65
26,10.36,3188.34,CUS-2487424745,9/28/2018,debit,20-30,2018,9,28,Friday,52855.65
26,9.69,3178.65,CUS-2487424745,9/28/2018,debit,20-30,2018,9,28,Friday,52855.65
26,5.57,3173.08,CUS-2487424745,9/28/2018,debit,20-30,2018,9,28,Friday,52855.65
26,8.78,3164.3,CUS-2487424745,9/28/2018,debit,20-30,2018,9,28,Friday,52855.65
26,12.45,3151.85,CUS-2487424745,9/28/2018,debit,20-30,2018,9,28,Friday,52855.65
26,9.33,3142.52,CUS-2487424745,9/28/2018,debit,20-30,2018,9,28,Friday,52855.65
26,18.54,3123.98,CUS-2487424745,9/28/2018,debit,20-30,2018,9,28,Friday,52855.65
26,8.13,3115.85,CUS-2487424745,9/28/2018,debit,20-30,2018,9,28,Friday,52855.65
26,10.45,3105.4,CUS-2487424745,9/28/2018,debit,20-30,2018,9,28,Friday,52855.65
26,5.59,3099.81,CUS-2487424745,9/28/2018,debit,20-30,2018,9,28,Friday,52855.65
26,6.29,3093.52,CUS-2487424745,9/28/2018,debit,20-30,2018,9,28,Friday,52855.65
26,17.5,3076.02,CUS-2487424745,9/29/2018,debit,20-30,2018,9,29,Saturday,52855.65
26,12.88,3063.14,CUS-2487424745,9/29/2018,debit,20-30,2018,9,29,Saturday,52855.65
26,17.27,3045.87,CUS-2487424745,9/29/2018,debit,20-30,2018,9,29,Saturday,52855.65
26,12.68,3033.19,CUS-2487424745,9/29/2018,debit,20-30,2018,9,29,Saturday,52855.65
26,15.9,3017.29,CUS-2487424745,9/29/2018,debit,20-30,2018,9,29,Saturday,52855.65
26,23.71,2993.58,CUS-2487424745,9/29/2018,debit,20-30,2018,9,29,Saturday,52855.65
26,14.37,2979.21,CUS-2487424745,9/29/2018,debit,20-30,2018,9,29,Saturday,52855.65
26,12.68,2966.53,CUS-2487424745,9/29/2018,debit,20-30,2018,9,29,Saturday,52855.65
26,24.77,2941.76,CUS-2487424745,9/29/2018,debit,20-30,2018,9,29,Saturday,52855.65
26,10.33,2931.43,CUS-2487424745,9/29/2018,debit,20-30,2018,9,29,Saturday,52855.65
26,27.15,2904.28,CUS-2487424745,9/29/2018,debit,20-30,2018,9,29,Saturday,52855.65
26,10.74,2893.54,CUS-2487424745,9/29/2018,debit,20-30,2018,9,29,Saturday,52855.65
26,3.3,2890.24,CUS-2487424745,9/30/2018,debit,20-30,2018,9,30,Sunday,52855.65
26,29.12,2861.12,CUS-2487424745,9/30/2018,debit,20-30,2018,9,30,Sunday,52855.65
26,5.3,2855.82,CUS-2487424745,9/30/2018,debit,20-30,2018,9,30,Sunday,52855.65
26,6.4,2849.42,CUS-2487424745,9/30/2018,debit,20-30,2018,9,30,Sunday,52855.65
26,8.46,2840.96,CUS-2487424745,9/30/2018,debit,20-30,2018,9,30,Sunday,52855.65
26,20,2820.96,CUS-2487424745,10/2/2018,debit,20-30,2018,10,2,Tuesday,52855.65
26,36,2784.96,CUS-2487424745,10/2/2018,debit,20-30,2018,10,2,Tuesday,52855.65
26,19.72,2765.24,CUS-2487424745,10/2/2018,debit,20-30,2018,10,2,Tuesday,52855.65
26,16.14,2749.1,CUS-2487424745,10/2/2018,debit,20-30,2018,10,2,Tuesday,52855.65
26,4.8,2744.3,CUS-2487424745,10/2/2018,debit,20-30,2018,10,2,Tuesday,52855.65
26,10.74,2733.56,CUS-2487424745,10/2/2018,debit,20-30,2018,10,2,Tuesday,52855.65
26,27.49,2706.07,CUS-2487424745,10/3/2018,debit,20-30,2018,10,3,Wednesday,52855.65
26,0.1,2705.97,CUS-2487424745,10/3/2018,debit,20-30,2018,10,3,Wednesday,52855.65
26,195,2510.97,CUS-2487424745,10/3/2018,debit,20-30,2018,10,3,Wednesday,52855.65
26,28.29,2482.68,CUS-2487424745,10/3/2018,debit,20-30,2018,10,3,Wednesday,52855.65
26,22.76,2459.92,CUS-2487424745,10/3/2018,debit,20-30,2018,10,3,Wednesday,52855.65
26,4.32,2455.6,CUS-2487424745,10/3/2018,debit,20-30,2018,10,3,Wednesday,52855.65
26,3.21,2452.39,CUS-2487424745,10/3/2018,debit,20-30,2018,10,3,Wednesday,52855.65
26,20.99,2431.4,CUS-2487424745,10/3/2018,debit,20-30,2018,10,3,Wednesday,52855.65
26,9.86,2421.54,CUS-2487424745,10/3/2018,debit,20-30,2018,10,3,Wednesday,52855.65
26,23.19,3412.02,CUS-2487424745,10/3/2018,debit,20-30,2018,10,3,Wednesday,52855.65
26,39.37,3372.65,CUS-2487424745,10/3/2018,debit,20-30,2018,10,3,Wednesday,52855.65
26,15.68,3356.97,CUS-2487424745,10/3/2018,debit,20-30,2018,10,3,Wednesday,52855.65
26,10.11,3346.86,CUS-2487424745,10/4/2018,debit,20-30,2018,10,4,Thursday,52855.65
26,6.11,3340.75,CUS-2487424745,10/4/2018,debit,20-30,2018,10,4,Thursday,52855.65
26,8.37,3332.38,CUS-2487424745,10/4/2018,debit,20-30,2018,10,4,Thursday,52855.65
26,6.71,3325.67,CUS-2487424745,10/4/2018,debit,20-30,2018,10,4,Thursday,52855.65
26,20.2,3305.47,CUS-2487424745,10/4/2018,debit,20-30,2018,10,4,Thursday,52855.65
26,20.8,3284.67,CUS-2487424745,10/4/2018,debit,20-30,2018,10,4,Thursday,52855.65
26,67.12,3217.55,CUS-2487424745,10/4/2018,debit,20-30,2018,10,4,Thursday,52855.65
26,15.36,3202.19,CUS-2487424745,10/4/2018,debit,20-30,2018,10,4,Thursday,52855.65
26,10.3,3191.89,CUS-2487424745,10/5/2018,debit,20-30,2018,10,5,Friday,52855.65
26,9.98,3181.91,CUS-2487424745,10/5/2018,debit,20-30,2018,10,5,Friday,52855.65
26,6.63,3175.28,CUS-2487424745,10/5/2018,debit,20-30,2018,10,5,Friday,52855.65
26,14.28,3161,CUS-2487424745,10/5/2018,debit,20-30,2018,10,5,Friday,52855.65
26,5.8,3155.2,CUS-2487424745,10/5/2018,debit,20-30,2018,10,5,Friday,52855.65
26,3.13,3152.07,CUS-2487424745,10/5/2018,debit,20-30,2018,10,5,Friday,52855.65
26,19.89,3132.18,CUS-2487424745,10/5/2018,debit,20-30,2018,10,5,Friday,52855.65
26,38.94,3093.24,CUS-2487424745,10/5/2018,debit,20-30,2018,10,5,Friday,52855.65
26,9.82,3083.42,CUS-2487424745,10/5/2018,debit,20-30,2018,10,5,Friday,52855.65
26,5.74,3077.68,CUS-2487424745,10/5/2018,debit,20-30,2018,10,5,Friday,52855.65
26,11.13,3066.55,CUS-2487424745,10/5/2018,debit,20-30,2018,10,5,Friday,52855.65
26,4.58,3061.97,CUS-2487424745,10/6/2018,debit,20-30,2018,10,6,Saturday,52855.65
26,15.82,3046.15,CUS-2487424745,10/6/2018,debit,20-30,2018,10,6,Saturday,52855.65
26,12.19,3033.96,CUS-2487424745,10/6/2018,debit,20-30,2018,10,6,Saturday,52855.65
26,15.47,3018.49,CUS-2487424745,10/6/2018,debit,20-30,2018,10,6,Saturday,52855.65
26,11.1,3007.39,CUS-2487424745,10/6/2018,debit,20-30,2018,10,6,Saturday,52855.65
26,14.22,2993.17,CUS-2487424745,10/7/2018,debit,20-30,2018,10,7,Sunday,52855.65
26,8.55,2984.62,CUS-2487424745,10/7/2018,debit,20-30,2018,10,7,Sunday,52855.65
26,31.64,2952.98,CUS-2487424745,10/7/2018,debit,20-30,2018,10,7,Sunday,52855.65
26,10.88,2942.1,CUS-2487424745,10/7/2018,debit,20-30,2018,10,7,Sunday,52855.65
26,9.99,2932.11,CUS-2487424745,10/7/2018,debit,20-30,2018,10,7,Sunday,52855.65
26,10.2,2921.91,CUS-2487424745,10/7/2018,debit,20-30,2018,10,7,Sunday,52855.65
26,8.23,2913.68,CUS-2487424745,10/7/2018,debit,20-30,2018,10,7,Sunday,52855.65
26,9.62,2904.06,CUS-2487424745,10/7/2018,debit,20-30,2018,10,7,Sunday,52855.65
26,32.77,2871.29,CUS-2487424745,10/8/2018,debit,20-30,2018,10,8,Monday,52855.65
26,33.94,2837.35,CUS-2487424745,10/8/2018,debit,20-30,2018,10,8,Monday,52855.65
26,4.7,2832.65,CUS-2487424745,10/8/2018,debit,20-30,2018,10,8,Monday,52855.65
26,22.84,2809.81,CUS-2487424745,10/8/2018,debit,20-30,2018,10,8,Monday,52855.65
26,6.59,2803.22,CUS-2487424745,10/8/2018,debit,20-30,2018,10,8,Monday,52855.65
26,1452.21,1351.01,CUS-2487424745,10/8/2018,debit,20-30,2018,10,8,Monday,52855.65
26,11.66,1339.35,CUS-2487424745,10/8/2018,debit,20-30,2018,10,8,Monday,52855.65
26,20.2,1319.15,CUS-2487424745,10/8/2018,debit,20-30,2018,10,8,Monday,52855.65
26,25.18,1293.97,CUS-2487424745,10/8/2018,debit,20-30,2018,10,8,Monday,52855.65
26,20,1273.97,CUS-2487424745,10/9/2018,debit,20-30,2018,10,9,Tuesday,52855.65
26,16.6,1257.37,CUS-2487424745,10/9/2018,debit,20-30,2018,10,9,Tuesday,52855.65
26,36,1221.37,CUS-2487424745,10/9/2018,debit,20-30,2018,10,9,Tuesday,52855.65
26,92,1129.37,CUS-2487424745,10/9/2018,debit,20-30,2018,10,9,Tuesday,52855.65
26,13.52,1115.85,CUS-2487424745,10/9/2018,debit,20-30,2018,10,9,Tuesday,52855.65
26,63,1052.85,CUS-2487424745,10/10/2018,debit,20-30,2018,10,10,Wednesday,52855.65
26,7,2059.52,CUS-2487424745,10/10/2018,debit,20-30,2018,10,10,Wednesday,52855.65
26,45.11,2014.41,CUS-2487424745,10/10/2018,debit,20-30,2018,10,10,Wednesday,52855.65
26,13.4,2001.01,CUS-2487424745,10/10/2018,debit,20-30,2018,10,10,Wednesday,52855.65
26,12.39,1988.62,CUS-2487424745,10/10/2018,debit,20-30,2018,10,10,Wednesday,52855.65
26,8.57,1980.05,CUS-2487424745,10/10/2018,debit,20-30,2018,10,10,Wednesday,52855.65
26,7.06,1972.99,CUS-2487424745,10/11/2018,debit,20-30,2018,10,11,Thursday,52855.65
26,67.49,1905.5,CUS-2487424745,10/11/2018,debit,20-30,2018,10,11,Thursday,52855.65
26,16.13,1889.37,CUS-2487424745,10/11/2018,debit,20-30,2018,10,11,Thursday,52855.65
26,10.18,1879.19,CUS-2487424745,10/11/2018,debit,20-30,2018,10,11,Thursday,52855.65
26,7.01,1872.18,CUS-2487424745,10/12/2018,debit,20-30,2018,10,12,Friday,52855.65
26,6.1,1866.08,CUS-2487424745,10/12/2018,debit,20-30,2018,10,12,Friday,52855.65
26,10.57,1855.51,CUS-2487424745,10/12/2018,debit,20-30,2018,10,12,Friday,52855.65
26,33.36,1822.15,CUS-2487424745,10/12/2018,debit,20-30,2018,10,12,Friday,52855.65
26,97.44,1724.71,CUS-2487424745,10/12/2018,debit,20-30,2018,10,12,Friday,52855.65
26,4.42,1720.29,CUS-2487424745,10/12/2018,debit,20-30,2018,10,12,Friday,52855.65
26,7.41,1712.88,CUS-2487424745,10/12/2018,debit,20-30,2018,10,12,Friday,52855.65
26,20.63,1692.25,CUS-2487424745,10/12/2018,debit,20-30,2018,10,12,Friday,52855.65
26,21.35,1670.9,CUS-2487424745,10/12/2018,debit,20-30,2018,10,12,Friday,52855.65
26,73.92,1596.98,CUS-2487424745,10/12/2018,debit,20-30,2018,10,12,Friday,52855.65
26,18.56,1578.42,CUS-2487424745,10/13/2018,debit,20-30,2018,10,13,Saturday,52855.65
26,10.08,1568.34,CUS-2487424745,10/13/2018,debit,20-30,2018,10,13,Saturday,52855.65
26,31.92,1536.42,CUS-2487424745,10/13/2018,debit,20-30,2018,10,13,Saturday,52855.65
26,15.39,1521.03,CUS-2487424745,10/13/2018,debit,20-30,2018,10,13,Saturday,52855.65
26,25.66,1495.37,CUS-2487424745,10/13/2018,debit,20-30,2018,10,13,Saturday,52855.65
26,7.93,1487.44,CUS-2487424745,10/13/2018,debit,20-30,2018,10,13,Saturday,52855.65
26,9.52,1477.92,CUS-2487424745,10/13/2018,debit,20-30,2018,10,13,Saturday,52855.65
26,612,839.09,CUS-2487424745,10/13/2018,debit,20-30,2018,10,13,Saturday,52855.65
26,13.41,1464.51,CUS-2487424745,10/13/2018,debit,20-30,2018,10,13,Saturday,52855.65
26,13.42,1451.09,CUS-2487424745,10/13/2018,debit,20-30,2018,10,13,Saturday,52855.65
26,11.64,827.45,CUS-2487424745,10/13/2018,debit,20-30,2018,10,13,Saturday,52855.65
26,6.9,820.55,CUS-2487424745,10/13/2018,debit,20-30,2018,10,13,Saturday,52855.65
26,5.72,814.83,CUS-2487424745,10/13/2018,debit,20-30,2018,10,13,Saturday,52855.65
26,5.8,809.03,CUS-2487424745,10/15/2018,debit,20-30,2018,10,15,Monday,52855.65
26,15.3,793.73,CUS-2487424745,10/15/2018,debit,20-30,2018,10,15,Monday,52855.65
26,4.67,789.06,CUS-2487424745,10/15/2018,debit,20-30,2018,10,15,Monday,52855.65
26,5.76,783.3,CUS-2487424745,10/15/2018,debit,20-30,2018,10,15,Monday,52855.65
26,35.63,747.67,CUS-2487424745,10/15/2018,debit,20-30,2018,10,15,Monday,52855.65
26,8.55,739.12,CUS-2487424745,10/15/2018,debit,20-30,2018,10,15,Monday,52855.65
26,26.07,713.05,CUS-2487424745,10/15/2018,debit,20-30,2018,10,15,Monday,52855.65
26,15.77,697.28,CUS-2487424745,10/15/2018,debit,20-30,2018,10,15,Monday,52855.65
26,14.5,682.78,CUS-2487424745,10/15/2018,debit,20-30,2018,10,15,Monday,52855.65
26,6.27,676.51,CUS-2487424745,10/15/2018,debit,20-30,2018,10,15,Monday,52855.65
26,3.77,672.74,CUS-2487424745,10/15/2018,debit,20-30,2018,10,15,Monday,52855.65
26,20,652.74,CUS-2487424745,10/16/2018,debit,20-30,2018,10,16,Tuesday,52855.65
26,36,616.74,CUS-2487424745,10/16/2018,debit,20-30,2018,10,16,Tuesday,52855.65
26,4.04,612.7,CUS-2487424745,10/16/2018,debit,20-30,2018,10,16,Tuesday,52855.65
26,5.77,1620.6,CUS-2487424745,10/17/2018,debit,20-30,2018,10,17,Wednesday,52855.65
26,4.92,1615.68,CUS-2487424745,10/17/2018,debit,20-30,2018,10,17,Wednesday,52855.65
26,21.83,1593.85,CUS-2487424745,10/18/2018,debit,20-30,2018,10,18,Thursday,52855.65
26,26.93,1566.92,CUS-2487424745,10/18/2018,debit,20-30,2018,10,18,Thursday,52855.65
26,11.37,1555.55,CUS-2487424745,10/18/2018,debit,20-30,2018,10,18,Thursday,52855.65
26,15.85,1539.7,CUS-2487424745,10/19/2018,debit,20-30,2018,10,19,Friday,52855.65
26,6,1533.7,CUS-2487424745,10/19/2018,debit,20-30,2018,10,19,Friday,52855.65
26,54.18,1479.52,CUS-2487424745,10/19/2018,debit,20-30,2018,10,19,Friday,52855.65
26,7.84,1471.68,CUS-2487424745,10/19/2018,debit,20-30,2018,10,19,Friday,52855.65
26,13.67,1458.01,CUS-2487424745,10/19/2018,debit,20-30,2018,10,19,Friday,52855.65
26,13.58,1444.43,CUS-2487424745,10/19/2018,debit,20-30,2018,10,19,Friday,52855.65
26,8.92,1435.51,CUS-2487424745,10/19/2018,debit,20-30,2018,10,19,Friday,52855.65
26,7.27,1428.24,CUS-2487424745,10/20/2018,debit,20-30,2018,10,20,Saturday,52855.65
26,22.06,1406.18,CUS-2487424745,10/20/2018,debit,20-30,2018,10,20,Saturday,52855.65
26,12.09,1394.09,CUS-2487424745,10/20/2018,debit,20-30,2018,10,20,Saturday,52855.65
26,8.83,1385.26,CUS-2487424745,10/20/2018,debit,20-30,2018,10,20,Saturday,52855.65
26,12.3,1372.96,CUS-2487424745,10/20/2018,debit,20-30,2018,10,20,Saturday,52855.65
26,6.27,1366.69,CUS-2487424745,10/20/2018,debit,20-30,2018,10,20,Saturday,52855.65
26,6.85,1359.84,CUS-2487424745,10/20/2018,debit,20-30,2018,10,20,Saturday,52855.65
26,7.62,1352.22,CUS-2487424745,10/20/2018,debit,20-30,2018,10,20,Saturday,52855.65
26,18.83,1333.39,CUS-2487424745,10/20/2018,debit,20-30,2018,10,20,Saturday,52855.65
26,6.93,1326.46,CUS-2487424745,10/20/2018,debit,20-30,2018,10,20,Saturday,52855.65
26,16.91,1309.55,CUS-2487424745,10/21/2018,debit,20-30,2018,10,21,Sunday,52855.65
26,4.13,1305.42,CUS-2487424745,10/21/2018,debit,20-30,2018,10,21,Sunday,52855.65
26,5.55,1299.87,CUS-2487424745,10/21/2018,debit,20-30,2018,10,21,Sunday,52855.65
26,14.25,1285.62,CUS-2487424745,10/21/2018,debit,20-30,2018,10,21,Sunday,52855.65
26,17.41,1268.21,CUS-2487424745,10/21/2018,debit,20-30,2018,10,21,Sunday,52855.65
26,23.63,1244.58,CUS-2487424745,10/21/2018,debit,20-30,2018,10,21,Sunday,52855.65
26,21.19,1223.39,CUS-2487424745,10/21/2018,debit,20-30,2018,10,21,Sunday,52855.65
26,9.35,1214.04,CUS-2487424745,10/21/2018,debit,20-30,2018,10,21,Sunday,52855.65
26,4.71,1209.33,CUS-2487424745,10/21/2018,debit,20-30,2018,10,21,Sunday,52855.65
26,7.65,1201.68,CUS-2487424745,10/22/2018,debit,20-30,2018,10,22,Monday,52855.65
26,9.54,1192.14,CUS-2487424745,10/22/2018,debit,20-30,2018,10,22,Monday,52855.65
26,9.28,1182.86,CUS-2487424745,10/22/2018,debit,20-30,2018,10,22,Monday,52855.65
26,21.63,1161.23,CUS-2487424745,10/22/2018,debit,20-30,2018,10,22,Monday,52855.65
26,14.15,1147.08,CUS-2487424745,10/22/2018,debit,20-30,2018,10,22,Monday,52855.65
26,41.97,1105.11,CUS-2487424745,10/22/2018,debit,20-30,2018,10,22,Monday,52855.65
26,20,1085.11,CUS-2487424745,10/23/2018,debit,20-30,2018,10,23,Tuesday,52855.65
26,12.31,1072.8,CUS-2487424745,10/23/2018,debit,20-30,2018,10,23,Tuesday,52855.65
26,36,1036.8,CUS-2487424745,10/23/2018,debit,20-30,2018,10,23,Tuesday,52855.65
26,8.8,1028,CUS-2487424745,10/23/2018,debit,20-30,2018,10,23,Tuesday,52855.65
26,4.28,1023.72,CUS-2487424745,10/23/2018,debit,20-30,2018,10,23,Tuesday,52855.65
26,9.61,1014.11,CUS-2487424745,10/23/2018,debit,20-30,2018,10,23,Tuesday,52855.65
26,14.74,999.37,CUS-2487424745,10/24/2018,debit,20-30,2018,10,24,Wednesday,52855.65
26,9.51,989.86,CUS-2487424745,10/24/2018,debit,20-30,2018,10,24,Wednesday,52855.65
26,10.58,979.28,CUS-2487424745,10/24/2018,debit,20-30,2018,10,24,Wednesday,52855.65
26,16.88,962.4,CUS-2487424745,10/24/2018,debit,20-30,2018,10,24,Wednesday,52855.65
26,9.29,953.11,CUS-2487424745,10/24/2018,debit,20-30,2018,10,24,Wednesday,52855.65
26,9.13,1957.65,CUS-2487424745,10/25/2018,debit,20-30,2018,10,25,Thursday,52855.65
26,7.45,1950.2,CUS-2487424745,10/25/2018,debit,20-30,2018,10,25,Thursday,52855.65
26,25.88,1924.32,CUS-2487424745,10/25/2018,debit,20-30,2018,10,25,Thursday,52855.65
26,8.12,1916.2,CUS-2487424745,10/26/2018,debit,20-30,2018,10,26,Friday,52855.65
26,17.43,1898.77,CUS-2487424745,10/26/2018,debit,20-30,2018,10,26,Friday,52855.65
26,10.91,1887.86,CUS-2487424745,10/26/2018,debit,20-30,2018,10,26,Friday,52855.65
26,9.65,1878.21,CUS-2487424745,10/26/2018,debit,20-30,2018,10,26,Friday,52855.65
26,5.6,1872.61,CUS-2487424745,10/26/2018,debit,20-30,2018,10,26,Friday,52855.65
26,220.38,1652.23,CUS-2487424745,10/26/2018,debit,20-30,2018,10,26,Friday,52855.65
26,15.19,1637.04,CUS-2487424745,10/26/2018,debit,20-30,2018,10,26,Friday,52855.65
26,16.04,1621,CUS-2487424745,10/26/2018,debit,20-30,2018,10,26,Friday,52855.65
26,9.99,1611.01,CUS-2487424745,10/28/2018,debit,20-30,2018,10,28,Sunday,52855.65
26,13.42,1597.59,CUS-2487424745,10/28/2018,debit,20-30,2018,10,28,Sunday,52855.65
26,17.55,1580.04,CUS-2487424745,10/28/2018,debit,20-30,2018,10,28,Sunday,52855.65
26,4.3,1575.74,CUS-2487424745,10/28/2018,debit,20-30,2018,10,28,Sunday,52855.65
26,5.24,1570.5,CUS-2487424745,10/28/2018,debit,20-30,2018,10,28,Sunday,52855.65
26,4.95,1565.55,CUS-2487424745,10/28/2018,debit,20-30,2018,10,28,Sunday,52855.65
26,13.98,1551.57,CUS-2487424745,10/28/2018,debit,20-30,2018,10,28,Sunday,52855.65
26,14.45,1537.12,CUS-2487424745,10/28/2018,debit,20-30,2018,10,28,Sunday,52855.65
26,10.04,1527.08,CUS-2487424745,10/29/2018,debit,20-30,2018,10,29,Monday,52855.65
26,6.33,1520.75,CUS-2487424745,10/29/2018,debit,20-30,2018,10,29,Monday,52855.65
26,6.48,1514.27,CUS-2487424745,10/29/2018,debit,20-30,2018,10,29,Monday,52855.65
26,20,1494.27,CUS-2487424745,10/30/2018,debit,20-30,2018,10,30,Tuesday,52855.65
26,36,1458.27,CUS-2487424745,10/30/2018,debit,20-30,2018,10,30,Tuesday,52855.65
26,11.91,1446.36,CUS-2487424745,10/30/2018,debit,20-30,2018,10,30,Tuesday,52855.65
26,16.68,1429.68,CUS-2487424745,10/30/2018,debit,20-30,2018,10,30,Tuesday,52855.65
26,3.62,1426.06,CUS-2487424745,10/30/2018,debit,20-30,2018,10,30,Tuesday,52855.65
26,10.2,1415.86,CUS-2487424745,10/30/2018,debit,20-30,2018,10,30,Tuesday,52855.65
26,33.51,1382.35,CUS-2487424745,10/31/2018,debit,20-30,2018,10,31,Wednesday,52855.65
26,2.76,1379.59,CUS-2487424745,10/31/2018,debit,20-30,2018,10,31,Wednesday,52855.65
26,4.09,1375.5,CUS-2487424745,10/31/2018,debit,20-30,2018,10,31,Wednesday,52855.65
26,10.46,1365.04,CUS-2487424745,10/31/2018,debit,20-30,2018,10,31,Wednesday,52855.65
26,4.23,1360.81,CUS-2487424745,10/31/2018,debit,20-30,2018,10,31,Wednesday,52855.65
26,62.98,1297.83,CUS-2487424745,10/31/2018,debit,20-30,2018,10,31,Wednesday,52855.65
26,29.71,1268.12,CUS-2487424745,10/31/2018,debit,20-30,2018,10,31,Wednesday,52855.65
26,10.24,2271.55,CUS-2487424745,10/31/2018,debit,20-30,2018,10,31,Wednesday,52855.65
26,10.74,2260.81,CUS-2487424745,10/31/2018,debit,20-30,2018,10,31,Wednesday,52855.65
26,24.37,2236.44,CUS-2487424745,10/31/2018,debit,20-30,2018,10,31,Wednesday,52855.65
26,16.3,2220.14,CUS-2487424745,10/31/2018,debit,20-30,2018,10,31,Wednesday,52855.65
26,25.88,2194.26,CUS-2487424745,10/31/2018,debit,20-30,2018,10,31,Wednesday,52855.65
26,46.2,2148.06,CUS-2487424745,10/31/2018,debit,20-30,2018,10,31,Wednesday,52855.65
26,13.2,2134.86,CUS-2487424745,10/31/2018,debit,20-30,2018,10,31,Wednesday,52855.65
